64 64
++++++++++++++++++++++++++++++++++++++++++++++++++++++++++++++++
+..............................................................+
+......+................................................+......+
+......+....................++++++++....................+......+
+.....+................++++..........++++................+.....+
+.....+..............++..................++..............+.....+
+...++.............++.........++++.........++.............++...+
+.++.............++......++++......++++......++.............++.+
+..............++......++..............++......++..............+
+.............+......++..................++......+.............+
+............+.....++......++++..++++......++.....+............+
+...........+....++......++..........++......++....+...........+
+..........+....+......++..............++......+....+..........+
+.........+....+.....++........++........++.....+....+.........+
+........+....+....++......++......++......++....+....+........+
+.......+....+....+......++..........++......+....+....+.......+
+.......+...+....+.....++......++......++.....+....+...+.......+
+......+...+....+....++......++..++......++....+....+...+......+
+......+...+...+....+......++......++......+....+...+...+......+
+.....+...+...+....+.....++..........++.....+....+...+...+.....+
+.....+...+...+...+....++..............++....+...+...+...+.....+
+....+...+...+...+....+......++..++......+....+...+...+...+....+
+....+...+...+...+...+.....++......++.....+...+...+...+...+....+
+...+...+...+...+...+....++..........++....+...+...+...+...+...+
+...+...+...+...+...+...+......++......+...+...+...+...+...+...+
+...+..+...+...+...+...+.....++..++.....+...+...+...+...+..+...+
+...+..+...+...+...+...+...++......++...+...+...+...+...+..+...+
+......+..+...+...+...+...+..........+...+...+...+...+..+......+
+..+...+..+...+...+...+...+..........+...+...+...+...+..+...+..+
+..+......+..+...+...+...+............+...+...+...+..+......+..+
+..+..+...+..+...+...+...+............+...+...+...+..+...+..+..+
+..+..+......+......+......................+......+......+..+..+
+..+..+......+......+......................+......+......+..+..+
+..+..+...+..+...+...+...+............+...+...+...+..+...+..+..+
+..+......+..+...+...+...+............+...+...+...+..+......+..+
+..+...+..+...+...+...+...+..........+...+...+...+...+..+...+..+
+......+..+...+...+...+...+..........+...+...+...+...+..+......+
+...+..+...+...+...+...+...++......++...+...+...+...+...+..+...+
+...+..+...+...+...+...+.....++..++.....+...+...+...+...+..+...+
+...+...+...+...+...+...+......++......+...+...+...+...+...+...+
+...+...+...+...+...+....++..........++....+...+...+...+...+...+
+....+...+...+...+...+.....++......++.....+...+...+...+...+....+
+....+...+...+...+....+......++..++......+....+...+...+...+....+
+.....+...+...+...+....++..............++....+...+...+...+.....+
+.....+...+...+....+.....++..........++.....+....+...+...+.....+
+......+...+...+....+......++......++......+....+...+...+......+
+......+...+....+....++......++..++......++....+....+...+......+
+.......+...+....+.....++......++......++.....+....+...+.......+
+.......+....+....+......++..........++......+....+....+.......+
+........+....+....++......++......++......++....+....+........+
+.........+....+.....++........++........++.....+....+.........+
+..........+....+......++..............++......+....+..........+
+...........+....++......++..........++......++....+...........+
+............+.....++......++++..++++......++.....+............+
+.............+......++..................++......+.............+
+..............++......++..............++......++..............+
+.++.............++......++++......++++......++.............++.+
+...++.............++.........++++.........++.............++...+
+.....+..............++..................++..............+.....+
+.....+................++++..........++++................+.....+
+......+....................++++++++....................+......+
+......+................................................+......+
+..............................................................+
++++++++++++++++++++++++++++++++++++++++++++++++++++++++++++++++
