130 50
++++++++++++++++++++++++++++++++++++++++++++++++++++++++++++++++++++++++++++++++++++++++++++++++++++++++++++++++++++++++++++++++++
+                                                                                                                               ++
+                        +                                                                                                      ++
+                   s  +                                                                                      s                 ++
+              +     +                                                                                                          ++
+                + +                                          + +                                            +                  ++
+                  +                                          + +         +                                                      +
+                    +                                                      +                                                   ++
+                                                                             +                                                 ++
+                                                                               +                                               ++
+                                                             +                  +                                              ++
+                                                             +                  +                 +++++++                      ++
+                +        +       +                                                                      +                      ++
+                                                                                +                   s   +                      ++
+                                                                                +                       +                      ++
+                                                                                  +                     +                      ++
+                                                                                    +                   +                       +
+                +        +        +                                                                                            ++
+                                                                                      + +   + +                                 + 
+      ++                                                                                                                       ++
+      + +                                                                                                                      ++
+          +                                                                                             +                      ++
+            +                                                                                           +                      ++
+                                      ++++++++++++++++++++++++++++                 +++++++              +                      ++
+                                                                 +                                                             ++
+                                     s                           +                                                             ++
+                         ++                                      +                                                             ++
+                         +++                                     +                                                              +
+                         ++   ++++                               +                                                             ++
+      +                         ++                               +                                                             ++
+      +                                                          +                                                             ++
+      +                         +++                              +                                                             ++
+      +                   ++++++++                                                                                             ++
+                           +  +                                                                                                ++
+      +                    +                                                                                                    +
+      +                    + + + + + +                                                                                         ++
+                   +                                                            + +         +              +                   ++
+                   +                                                            +                                              ++
+                   +                                                            +                                              ++
+                   +                                                            +                                               +
+                   +                          +                                 +                    s                         ++
+                                              +                                 +                                              ++
+                                              +                                 +                                              ++
+                                              +                                 +                   +                           +
+                                              +                                                                                ++
+          s                                                                                                                    ++
+                                                                                                                                +
+                                                                                                                               ++
+  +++++++++++      ++++++++++++++++++++++++++      +++++++++++++++++++++++++++++++++     ++++++++++++++++++++++++++++++++++++++++
++++++++++++++++++++++++++++++++++++++++++++++++++++++++++++++++++++++++++++++++++++++++++++++++++++++++++++++++++++++++++++++++++
