50 50
++++++++++++++++++++++++++++++++++++++++++++++++++
+           + +  +++++    + +        +  + +      +
+ +   + +             +      +    +    +  +    + +
+   + +         ++         +   +  +         +  +++
+    ++      +++  +   +      +       +    +  ++  +
+  +          ++      ++  +        + +         + +
+    +  + ++  + +      ++        +++     ++ +    +
+ +   +   ++ +  +  +         +    +  +  +   +    +
++  + +   ++    + + +  +      +    +     +  +++  +
+++ +      + + ++           +      + +      +    +
+     +  +++ +   +     +   ++ +   +         ++  ++
+ ++  +   ++   +    +         +    ++  +      ++ +
+ + +        +++ +          + +++   +  +  +   ++ +
+ + +++   ++    +     +   ++         + +       + +
+ + + + +++  +  ++    ++    +  +        + + +  + +
++   +        +                  ++    ++        +
++ +   ++ + +       ++      + ++ +  + +  ++ + ++ +
++ +  ++ ++     ++ ++  + +           +     +   + +
+   +    ++   +  + +   +    +           +   +++  +
+       +  +        +  ++ ++      +  + +       + +
+ +  +++  + +    + + +  +   +        +  +        +
+     +      +                +      +  + +   +  +
++  +  +        +   ++  ++ + ++   + +    + +     +
+ +    ++ +     +     +  +++  + ++     +         +
+  + +  +           + +       ++     ++++    +  ++
+ + +    +   +    +          ++        + +    +  +
+  +   + +    + +    + +++    +    +             +
+  ++      +  +   +     +   ++   +  +  +++++     +
+ +    +   + + +   ++   + +      +     +    ++   +
+   +  ++  +                  + +      +  ++ +   +
+    + +++  +    +     + +  +          ++ +  ++ ++
+ +    +  +            +     ++ + +       +    + +
+   +   +    +   ++      +    + +++   ++     + + +
++  ++  +     + ++       +     +         +       +
+ ++   +  ++++++      ++ ++   ++  +    +         +
++      ++ +      ++  ++      +++   +        +   +
+      +   ++   +++   +  + ++  +  + + ++    +    +
+  + + ++ +   + ++          +   +       +    +   +
++  ++  +  +  +++ +   + ++    +    + +  +        +
+  + +   +  ++   +++  +       ++  +    +   + +   +
+    +       ++++ +  ++++ +  ++ ++     ++  ++    +
++    +            + +  +  +   + ++  +  +  + + +++
+++    +                  +++ +   +  +    +    +++
+  ++     ++  + +       ++   + +         + +++++++
++  +  + ++   +         +  + +  +   +       ++ + +
++ + +   + +  + + +     +                 ++     +
+  ++       ++       + + +   +            ++    ++
+++++      ++   ++     +     + +     +++     +++ +
++       + ++ +     +  +  +   +         ++ +    ++
++++++++++++++++++++++++++++++++++++++++++++++++++
