50 50
++++++++++++++++++++++++++++++++++++++++++++++++++
+           + +  +++++    + +        +  + +      +
+ +   + +             +      +    +    +  +    + +
+   + +         ++         +   +  +         +  +++
+    ++      +++  +   +      +       +    +  ++  +
+  +          ++      ++  +        + +         + +
+    +  + ++  + +      ++        +++     ++ +    +
+ +   +   ++ +  +  +         +    +  +  +   +    +
++  + +   ++    + + +  +      +    +     +  +++  +
+++ +      + + ++           +      + +      +    +
+     +  +++ +   +     +   ++ +   +         ++  ++
+ ++  +   ++   +    +         +    ++  +      ++ +
+ + +        +++ +          + +++   +  +  +   ++ +
+ + +++   ++    +     +   ++         + +       + +
+ + +   +++  +  ++    ++    +  +        + + +  + +
++   +        +                  ++    ++        +
++ +   ++ + +       ++      + ++ +  + +  ++ + ++ +
++ +  ++ ++     ++ ++  + +     +     +     +   + +
+   +    ++   +  + +   +    +  +        +   +++  +
+       +  +        +  ++ ++   +  +  + +       + +
+ +  +++  + +    + + +  +   +        +  +        +
+     +      +                +      +  + +   +  +
++  +  +        +   ++  ++ + ++   + +    + +     +
+ +    ++ +     +     +  +++  + ++     +         +
+  + +  +           + +       ++     ++++    +  ++
+ +      +   +    +          ++        + +    +  +
+  +   + +    + +    + +++    +    +             +
+  ++      +  +   +     +   ++   +  +  +++++     +
+ +    +   + + +   ++   + +      +     +    ++   +
+   +  ++  +                  + +      +  ++ +   +
+    + +++  +    +     + +  +          ++ +  ++ ++
+ +    +  +            +     ++ + +       +    + +
+   +   +    +   ++      +    + +++   ++     + + +
++  ++  +     + ++       +     +         +       +
+ ++   +  ++++++      ++ ++   ++  +    +         +
+       ++ +      ++  ++      +++   +        +   +
+      +   ++   +++   +  + ++  +  + + ++    +    +
+  + + ++ +   + ++          +   +       +    +   +
++  ++  +  +  +++ +   + ++    +    + +  +        +
+  + +   +  ++   +++  +   +   ++  +    +   + +   +
+    +       ++++ +  ++++ +  +  ++     ++  ++    +
++    +            + +  +  +   + ++  +  +  + + +++
+++    +                  +++ +   +  +    +    +++
+  ++     ++  + +       ++   + +         + +++++++
++     + ++   +         +  + +  +   +       ++ + +
++ + +   + +  + + +     +                 ++     +
+  ++       ++       + + +   +            ++    ++
+++++      ++   ++     +     + +     +++     +++ +
++       + ++ +     +  +  +   +         ++ +    ++
++++++++++++++++++++++++++++++++++++++++++++++++++
