50 50
++++++++++++++++++++++++++++++++++++++++++++++++++
+...........+.+..+++++....+.+........+..+.+......+
+.+...+.+.............+......+....+....+..+....+.+
+...+.+.........++.........+...+..+.........+..+++
+....++......+++..+...+......+.......+....+..++..+
+..+..........++......++..+........+.+.........+.+
+....+..+.++..+.+......++........+++.....++.+....+
+.+...+...++.+.++..+.........+....+..+..+.+.+....+
++..+.+...++....+.+.+..+......+....+.....+..+++..+
+++.+......+.+.++...........+......+.+......+....+
+.....+..+++.+...+.....+...++.+...+.........++..++
+.++..+...++...+....+.........+....++..+......++.+
+.+.+........+++.+..........+.+++...+..+..+...++.+
+.+.+++...++....+.....+...++.+.......+.+.......+.+
+.+.+.+.+++..+..++....++....+..+........+.+.+..+.+
++...+........+..................++....++........+
++.+...++.+.+.......++......+.++.+..+.+..++.+.++.+
++.+..++.++.....++.++..+.+...........+.....+.+.+.+
+...+....++...+..+.+...+....+...........+...+++..+
+.......+..+........+..++.++......+..+.+.......+.+
+.+..+++..+.+....+.+.+..+...+........+..+........+
+.....+......+................+......+..+.+...+..+
++..+..+........+...++..++.+.++...+.+....+.+.....+
+.+....++.+.....+.....+..+++..+.++.....+.........+
+..+.+..+...........+.+.......++.....++++....+..++
+.+.+....+...+....+..........++........+.+....+..+
+..+...+.+....+.+....+.+++....+....+.............+
+..++......+..+...+.....+...++...+..+..+++++.....+
+.+....+...+.+.+...++...+.+......+.....+..+.++...+
+...+..++..+..................+.+......+..++.+...+
+....+.+++..+....+.....+.+..+..........++.+..++.++
+.+....+..+............+.....++.+.+.......+....+.+
+...+...+....+...++......+....+.+++...++.....+.+.+
++..++..+.....+.++.......+.....+.........+.......+
+.++...+..++++++......++.++...++..+....+.........+
++......++.+....+.++..++......+++...+........+...+
+......+...++...+++...+..+.++..+..+.+.++....+....+
+..+.+.++.+...+.++..........+...+.......+....+...+
++..++..+..+..+++.+...+.++....+....+.+..+........+
+..+.+...+..++...+++..+.......++..+....+...+.+...+
+....+.......++++.+..++++.+..++.++.....++..++....+
++....+............+.+..+..+...+.++..+..+..+.+.+++
+++....+..................+++.+...+..+....+....+++
+..++.....++..+.+.......++...+.+.........+.+++++++
++..+..+.++...+.........+..+.+..+...+.......++.+.+
++.+.+...+.+..+.+.+.....+.................++.....+
+..++.......++.......+.+.+...+............++....++
+++++......++...++.....+.....+.+.....+++.....+++.+
++.......+.++.+.....+..+..+...+.........++.+....++
++++++++++++++++++++++++++++++++++++++++++++++++++
