128 128
++++++++++++++++++++++++++++++++++++++++++++++++++++++++++++++++++++++++++++++++++++++++++++++++++++++++++++++++++++++++++++++++
+..............................................................................................................................+
+..............................................................................................................................+
+..............................................................................................................................+
+..............................................................................................................................+
+..............................................................................................................................+
+..............................................................................................................................+
+..............................................................................................................................+
+..............................................................................................................................+
+..............................................................................................................................+
+..............................................................................................................................+
+..............................................................................................................................+
+..............................................................................................................................+
+..............................................................................................................................+
+..............................................................................................................................+
+...................................................++++++............++++++...................................................+
+...............................................+++++......................+++++...............................................+
+.............................................+++..............................+++.............................................+
+..........................................++++..................................++++..........................................+
+........................................+++........................................+++........................................+
+......................................+++............................................+++......................................+
+.....................................++................................................++.....................................+
+...................................+++..................................................+++...................................+
+..................................++......................................................++..................................+
+..............................................................................................................................+
+..............................................................................................................................+
+..............................................................................................................................+
+..............................................................................................................................+
+..............................................................................................................................+
+..............................................................................................................................+
+..............................................................................................................................+
+..............................................................................................................................+
+..............................................................................................................................+
+..............................................................................................................................+
+..............................................................................................................................+
+......................+................................................................................+......................+
+.....................++................................................................................++.....................+
+.....................+..................................................................................+.....................+
+....................++..................................................................................++....................+
+...................++....................................................................................++...................+
+...................+..................................++++..........++++..................................+...................+
+..................++................................++++++..........++++++................................++..................+
+..................+...............................++++++++..........++++++++...............................+..................+
+.................++..............................+++++++++..........+++++++++..............................++.................+
+.................+.............................+++++++++++..........+++++++++++.............................+.................+
+.................+............................++++++++++++..........++++++++++++............................+.................+
+................++...........................+++++++++++++..........+++++++++++++...........................++................+
+................+...........................++++++++++++++..........++++++++++++++...........................+................+
+...............++..........................+++++++++++++++..........+++++++++++++++..........................++...............+
+...............+...........................+++++++++++++++..........+++++++++++++++...........................+...............+
+...............+..........................++++++++++++++..............++++++++++++++..........................+...............+
+...............+.........................++++++++++++++................++++++++++++++.........................+...............+
+..............++.........................++++++++++++....................++++++++++++.........................++..............+
+..............+.........................++++++++++++......................++++++++++++.........................+..............+
+..............+.........................+++++++++++........................+++++++++++.........................+..............+
+..............+........................++++++++++++........................++++++++++++........................+..............+
+..............+........................+++++++++++..........................+++++++++++........................+..............+
+..............+........................++++++++++............................++++++++++........................+..............+
+.......................................++++++++++............................++++++++++.......................................+
+..............................................................................................................................+
+..............................................................++..............................................................+
+............................................................++++++............................................................+
+...........................................................++++++++...........................................................+
+...........................................................++++++++...........................................................+
+..........................................................++++++++++..........................................................+
+..........................................................++++++++++..........................................................+
+...........................................................++++++++...........................................................+
+...........................................................++++++++...........................................................+
+............................................................++++++............................................................+
+.......................................++++++++++.............++.............++++++++++.......................................+
+..............+........................++++++++++............................++++++++++........................+..............+
+..............+........................+++++++++++..........................+++++++++++........................+..............+
+..............+........................++++++++++++........................++++++++++++........................+..............+
+..............+.........................+++++++++++........................+++++++++++.........................+..............+
+..............+.........................++++++++++++......................++++++++++++.........................+..............+
+..............++.........................++++++++++++....................++++++++++++.........................++..............+
+...............+.........................++++++++++++++................++++++++++++++.........................+...............+
+...............+..........................++++++++++++++..............++++++++++++++..........................+...............+
+...............+...........................+++++++++++++++..........+++++++++++++++...........................+...............+
+...............++..........................+++++++++++++++..........+++++++++++++++..........................++...............+
+................+...........................++++++++++++++..........++++++++++++++...........................+................+
+................++...........................+++++++++++++..........+++++++++++++...........................++................+
+.................+............................++++++++++++..........++++++++++++............................+.................+
+.................+.............................+++++++++++..........+++++++++++.............................+.................+
+.................++..............................+++++++++..........+++++++++..............................++.................+
+..................+...............................++++++++..........++++++++...............................+..................+
+..................++................................++++++..........++++++................................++..................+
+...................+..................................++++..........++++..................................+...................+
+...................++....................................................................................++...................+
+....................++..................................................................................++....................+
+.....................+..................................................................................+.....................+
+.....................++................................................................................++.....................+
+......................+................................................................................+......................+
+..............................................................................................................................+
+..............................................................................................................................+
+..............................................................................................................................+
+..............................................................................................................................+
+..............................................................................................................................+
+..............................................................................................................................+
+..............................................................................................................................+
+..............................................................................................................................+
+..............................................................................................................................+
+..............................................................................................................................+
+................................+++........................................................+++................................+
+..................................++......................................................++..................................+
+...................................+++..................................................+++...................................+
+.....................................++................................................++.....................................+
+......................................+++............................................+++......................................+
+........................................+++........................................+++........................................+
+..........................................++++..................................++++..........................................+
+.............................................+++..............................+++.............................................+
+...............................................+++++......................+++++...............................................+
+...................................................++++++............++++++...................................................+
+..............................................................................................................................+
+..............................................................................................................................+
+..............................................................................................................................+
+..............................................................................................................................+
+..............................................................................................................................+
+..............................................................................................................................+
+..............................................................................................................................+
+..............................................................................................................................+
+..............................................................................................................................+
+..............................................................................................................................+
+..............................................................................................................................+
+..............................................................................................................................+
+..............................................................................................................................+
+..............................................................................................................................+
++++++++++++++++++++++++++++++++++++++++++++++++++++++++++++++++++++++++++++++++++++++++++++++++++++++++++++++++++++++++++++++++
