10 10
++++++++++
+s       +
+ ++   s +
+ +s     +
+ +    + +
+ +    + +
+     s+ +
+ s   ++ +
+       s+
++++++++++
