10 10
++++++++++
+        +
+ ++     +
+ +      +
+ +    + +
+ +    + +
+      + +
+     ++ +
+        +
++++++++++
