20 10
++++++++++++++++++++
+s                s+
+ ++        s+     +
+ +s       +++     +
+ +         s+   + +
+ +    +s        + +
+      +++      s+ +
+      +s       ++ +
+s                s+
++++++++++++++++++++