20 10
++++++++++++++++++++
+                  +
+ ++         +     +
+ +        +++     +
+ +          +   + +
+ +    +         + +
+      +++       + +
+      +        ++ +
+                  +
++++++++++++++++++++